Sequence	name	direction	Assay
ACTGGAAATTGTCCCAATAACT	WDR70_poor_spliced_ds_exon_REV	rev	Splicing efficiency validation
GGCAAGGACATTACCATCATAG	WDR70_poor_spliced_intron_FWD	fwd	Splicing efficiency validation
TAAACCACGGACGATGCAA	WDR70_poor_spliced_us_exon_FWD	fwd	Splicing efficiency validation
ATCTGTCCGTAGACACTCTTAATG	WDR70_well_spliced_intron_FWD 	fwd	Splicing efficiency validation
GGAAAGTCCTACGCTCAAAGA	WDR70_well_spliced_ds_exon_REV 	rev	Splicing efficiency validation
GGGACATCCGACAATTTAATAAACC	WDR70_well_spliced_us_exon_FWD	fwd	Splicing efficiency validation
CCTGAAGCCAAGAAGCTGAT	PDCD11 FWD 	fwd	cryptic splicing validation
CCTTTCTTCTGACTGTGTCCTG	PDCD11 REV 	rev	cryptic splicing validation
TGCAAGTGTGTTTCCATCTCGTCTCG	Golga3_FWD	fwd	cryptic splicing validation
TGGAACACCTGCAGCAGGAG	Golga3_REV	rev	cryptic splicing validation
CAGTTGTAAATGGCTACTGGTCACAAAC	URB1_FWD	fwd	cryptic splicing validation
TCATCTCTGAGCAGGGCCTTCGA	URB1_REV	rev	cryptic splicing validation
CTTCTGGCTTCTCTTCAGCAGC	FANCAe_FWD	fwd	cryptic splicing validation
CTCCCCAAAGTCCCTGACTCCC	FANCA_REV	rev	cryptic splicing validation
CTCTGCTCTTCCAGCGTTGAGTAG	Â GOLGA1_FWD	fwd	cryptic splicing validation
CTGACAGCCCAGTTACAGG	GOLGA1_REV	rev	cryptic splicing validation
CCGAGGATTCTGAAGACGACGGGG	PHRF1_FWD	fwd	cryptic splicing validation
ACCACCAAATTGAGCTCGAATACAAA	PHRF1_REV	rev	cryptic splicing validation
CCTTGATAATCCAGCTCCAAGATTA	ZCCHC6_FWD	fwd	cryptic splicing validation
CCTACCTATTGGTCAGAATGTGGA	ZCCHC6_REV	rev	cryptic splicing validation
GATTCTAAACTGCCTTCCTCGG	WDR37_FWD	fwd	cryptic splicing validation
CTTTTGTTTTGAGTTGGCCCT	WDR37_REV	rev	cryptic splicing validation
